1111111111111111111111111111111111
1E000000K000000C00000CK00000000001
1010010100100000101001000000010101
10100100101010100010010000K0010101
1P000K000C00C000000000000000000KC1
1111111111111111111111111111111111
